WE      ./textures/west.xpm

NO 			./textures/north.xpm
               SO ./textures/south.xpm
	EA             ./textures/east.xpm

F      0    ,    0, 0
C 			255,30,0









1111111111111111111111111
1000000000110000000000001
1011000001110000000000001
1001000001000000000000001
111111111 1011000001110001
1000000001110000011101111
1111011111111101110000001
1111011111111101110101001
1100000011010101110000001
1000000000000000110E00001
1000000000000000110101001
1100000111010101111101111
1111011101110101010111101
1111111111111111111111111



