1111111111111111111111111111111
1000000000110000000000001111111
1011000001110000000000001111001
1001000000000000000000001000001
1111111110110000011100001000001
1000000000110000011101111000001
1111011111111101110000001100101
1111011111111101110101001000001
1100000011010101110000001000001
10000N0000000000110000001000001
1000000000000000110101001000001
1100000111010101111101111000001
1111011101110101010111101000001
1111111111111111111111101000001
1100000111010101111101101000001
1111011101110101010111001000001
1111111111111111111111111000001